209 200 211 104 103 210 200 203 200 200 200 200 200 200 200 200 200 200 200 200 203 200 200 200 203 200 200 200 200 203 200 200 203 203 200 200 200 200 200 200 200 200 203 203 200 200 203 200 200 208
201 107 101 111 109 101 105 201 113 113 113 113 113 402 113 302 113 113 113 113 201 107 101 105 201 113 113 113 113 201 113 113 204 206 107 101 101 101 101 101 101 105 207 205 113 113 201 113 113 201
201 104 100 100 100 100 103 201 113 301 113 113 113 401 113 113 113 113 113 113 201 104 100 103 201 113 300 300 113 201 113 209 206 107 111 100 100 100 100 100 100 109 105 207 205 113 201 113 300 201
201 104 100 100 100 100 103 201 113 113 113 300 113 400 113 113 113 300 113 113 201 104 100 103 201 113 113 113 113 204 203 206 107 111 100 112 102 102 102 102 110 100 109 105 207 203 205 113 113 201
201 106 102 110 100 100 103 201 113 113 113 113 113 113 113 113 113 113 113 113 201 104 100 103 201 113 113 113 113 204 206 107 111 100 112 108 209 200 200 208 106 110 100 109 105 207 205 113 113 201
201 113 113 106 102 102 108 204 200 200 200 200 200 200 200 200 200 200 200 200 206 104 100 103 201 113 300 300 113 201 107 111 100 112 108 209 206 113 113 207 208 106 110 100 109 105 201 301 113 201
201 107 101 105 209 200 200 205 107 101 101 101 101 101 101 101 101 101 101 105 113 104 100 103 201 113 113 113 113 201 104 100 112 108 209 206 113 113 113 113 207 208 106 110 100 103 201 113 113 201
201 104 100 103 201 300 113 201 104 100 100 100 100 100 100 100 100 100 100 103 113 104 100 103 201 113 113 113 113 201 104 100 103 209 206 113 113 113 113 113 113 207 208 104 100 103 201 113 113 201
201 104 100 103 201 113 300 201 104 100 112 102 102 102 102 102 102 102 102 108 113 104 100 103 207 200 200 200 200 206 104 100 103 201 113 113 402 113 113 402 113 113 201 104 100 103 201 113 113 201
201 104 100 103 207 200 200 205 104 100 103 210 200 200 200 200 200 200 200 200 208 104 100 103 113 107 101 101 101 101 111 100 103 201 113 113 401 113 113 401 113 113 201 104 100 103 201 300 113 201
201 104 100 103 113 113 113 201 104 100 109 101 101 101 101 101 101 101 101 105 201 104 100 103 113 104 100 100 100 100 100 100 103 201 113 113 400 303 304 400 113 113 201 104 100 103 201 113 113 201
201 104 100 103 113 113 113 201 104 100 100 100 100 100 100 100 100 100 100 103 201 104 100 103 113 106 102 102 102 102 102 102 108 201 113 113 113 113 113 113 113 113 201 104 100 103 201 113 113 201
201 104 100 103 209 200 200 205 106 102 102 102 102 102 102 102 102 110 100 103 201 104 100 103 209 200 200 200 200 200 200 200 200 202 200 200 200 200 200 200 200 200 205 104 100 103 201 113 302 201
201 104 100 103 201 300 113 204 200 200 200 200 200 200 200 200 208 104 100 103 201 104 100 103 201 113 113 113 113 113 113 113 113 113 113 113 113 113 113 113 113 113 201 104 100 103 201 113 113 201
201 104 100 103 201 113 300 201 113 113 113 113 113 113 113 113 201 104 100 103 201 104 100 103 201 113 113 113 113 113 113 113 113 113 113 113 113 113 113 113 113 113 201 104 100 103 201 113 113 201
201 104 100 103 201 113 113 201 113 113 113 113 113 113 113 113 201 106 102 108 201 106 102 108 201 113 113 113 113 113 113 113 209 200 200 200 200 200 200 200 200 200 206 106 102 108 207 200 200 205
201 104 100 103 207 200 200 212 200 200 200 200 200 200 200 200 206 113 113 113 207 200 200 200 202 200 200 200 200 200 200 200 205 107 101 101 101 101 101 101 101 101 101 101 101 101 101 101 105 201
201 104 100 103 113 113 113 201 107 101 105 113 107 101 101 101 101 101 101 101 101 101 101 101 101 101 101 101 101 105 113 113 201 104 100 100 100 100 100 100 100 100 100 100 100 100 100 100 103 201
201 104 100 103 113 113 113 201 104 100 103 113 104 100 100 100 100 100 100 100 100 100 100 100 100 100 100 100 100 103 113 113 201 106 102 102 102 102 102 102 102 102 102 102 102 102 102 102 108 201
201 104 100 103 209 200 200 205 104 100 103 113 106 102 102 102 102 102 102 102 102 102 102 102 102 102 102 102 102 108 113 113 201 107 101 105 209 200 200 200 200 200 208 107 101 105 209 200 200 205
201 106 102 108 201 113 300 201 104 100 103 209 200 200 200 200 200 200 200 200 200 200 200 200 200 200 200 200 200 200 200 200 205 104 100 103 201 113 113 113 113 113 201 104 100 103 201 113 113 201
201 113 113 113 201 113 113 201 104 100 103 201 113 113 113 113 113 113 113 113 113 113 113 113 113 113 113 113 113 113 113 113 201 104 100 103 201 113 402 113 113 113 201 104 100 103 201 113 302 201
201 113 113 113 201 300 113 201 104 100 103 201 113 113 402 113 301 113 113 113 113 302 113 113 113 113 113 113 113 402 113 113 201 104 100 103 201 113 401 113 113 113 201 104 100 103 201 113 113 201
201 113 113 113 207 200 200 206 104 100 103 201 113 113 401 113 113 113 113 113 113 113 113 402 113 300 113 113 113 401 113 113 201 104 100 103 201 113 400 113 113 113 201 104 100 103 201 113 113 201
201 107 101 101 101 101 101 101 111 100 103 201 113 113 400 113 113 300 113 113 113 113 113 401 113 113 113 113 113 400 113 113 201 104 100 103 201 113 113 113 113 113 201 104 100 103 201 113 113 201
201 104 100 100 100 100 100 100 100 100 103 201 113 113 113 113 113 113 113 113 300 113 113 400 113 113 113 300 113 113 113 113 201 104 100 103 201 113 113 113 403 113 201 104 100 103 201 113 302 201
201 106 102 102 102 102 102 102 110 100 103 201 113 113 113 113 113 113 402 113 113 113 113 113 113 301 113 113 113 113 402 113 201 104 100 103 201 113 113 113 113 113 201 104 100 103 201 113 113 201
204 200 200 200 200 200 200 208 104 100 103 201 113 113 300 113 113 113 401 113 113 302 113 113 113 113 113 113 113 113 401 113 201 104 100 103 201 113 113 113 113 113 201 104 100 103 201 113 113 201
201 113 300 113 300 113 113 201 104 100 103 201 113 113 113 113 301 113 400 113 113 113 113 113 302 113 113 113 301 113 400 113 201 104 100 103 201 113 113 209 200 200 206 104 100 103 207 200 200 205
201 113 113 113 113 113 113 201 104 100 103 201 113 113 113 113 113 113 113 113 113 113 113 113 113 113 113 113 113 113 113 113 201 104 100 103 201 113 113 201 107 101 101 111 100 109 101 101 105 201
204 200 200 200 200 200 200 206 106 102 108 207 200 200 200 200 200 200 200 200 200 200 200 200 200 200 200 200 200 200 200 200 206 106 102 108 207 200 200 205 104 100 100 100 100 100 100 100 103 201
201 107 101 101 101 101 101 101 101 101 101 101 101 101 101 101 101 101 101 101 101 101 101 101 101 101 101 101 101 101 101 101 101 101 101 101 101 101 105 201 104 100 100 100 100 100 100 100 103 201
201 104 100 100 100 100 100 100 100 100 100 100 100 100 100 100 100 100 100 100 100 100 100 100 100 100 100 100 100 100 100 100 100 100 100 100 100 100 103 201 104 100 100 100 100 100 100 100 103 201
201 106 102 102 102 102 102 102 102 102 102 102 102 102 102 102 102 102 102 102 102 102 102 102 102 102 102 102 102 102 102 102 102 102 102 102 102 102 108 201 104 100 100 100 500 100 100 100 103 201
201 113 113 113 209 200 200 200 200 200 200 200 200 200 200 200 200 200 200 200 200 200 200 200 200 200 200 200 200 200 200 200 200 200 200 200 200 200 200 205 104 100 100 100 100 100 100 100 103 201
201 113 113 113 201 113 113 113 302 113 113 113 113 113 113 113 301 113 113 113 113 113 113 113 300 113 113 300 300 113 113 113 113 113 113 300 113 113 113 201 104 100 100 100 100 100 100 100 103 201
201 113 113 113 201 113 113 113 113 113 113 113 300 300 113 113 113 113 301 113 300 300 113 113 113 113 113 113 113 113 113 302 113 113 113 113 113 301 113 201 106 102 102 102 102 102 102 102 108 201
207 200 200 200 202 200 200 200 200 200 200 200 200 200 200 200 200 200 200 200 200 200 200 200 200 200 200 200 200 200 200 200 200 200 200 200 200 200 200 202 200 200 200 200 200 200 200 200 200 206