200 200 200 104 103 200 200 200 200 200 200 200 200 200 200 200 200 200 200 200 200 200 200 200 200 200 200 200 200 200 200 200 200 200 200 200 200 200 200 200 200 200 200 200 200 200 200 200 200 200
200 107 101 111 109 101 105 200 113 113 113 113 113 402 113 302 113 113 113 113 200 107 101 105 200 113 113 113 113 200 113 113 200 200 107 101 101 101 101 101 101 105 200 200 113 113 200 113 113 200
200 104 100 100 100 100 103 200 113 301 113 113 113 401 113 113 113 113 113 113 200 104 100 103 200 113 300 300 113 200 113 200 200 107 111 100 100 100 100 100 100 109 105 200 200 113 200 113 300 200
200 104 100 100 100 100 103 200 113 113 113 300 113 400 113 113 113 300 113 113 200 104 100 103 200 113 113 113 113 200 200 200 107 111 100 112 102 102 102 102 110 100 109 105 200 200 200 113 113 200
200 106 102 110 100 100 103 200 113 113 113 113 113 113 113 113 113 113 113 113 200 104 100 103 200 113 113 113 113 200 200 107 111 100 112 108 200 200 200 200 106 110 100 109 105 200 200 113 113 200
200 113 113 106 102 102 108 200 200 200 200 200 200 200 200 200 200 200 200 200 200 104 100 103 200 113 300 300 113 200 107 111 100 112 108 200 200 113 113 200 200 106 110 100 109 105 200 301 113 200
200 107 101 105 200 200 200 200 107 101 101 101 101 101 101 101 101 101 101 105 113 104 100 103 200 113 113 113 113 200 104 100 112 108 200 200 113 113 113 113 200 200 106 110 100 103 200 113 113 200
200 104 100 103 200 300 300 200 104 100 100 100 100 100 100 100 100 100 100 103 113 104 100 103 200 113 113 113 113 200 104 100 103 200 200 113 113 113 113 113 113 200 200 104 100 103 200 113 113 200
200 104 100 103 200 300 300 200 104 100 112 102 102 102 102 102 102 102 102 108 113 104 100 103 200 200 200 200 200 200 104 100 103 200 113 113 402 113 113 402 113 113 200 104 100 103 200 113 113 200
200 104 100 103 200 200 200 200 104 100 103 200 200 200 200 200 200 200 200 200 200 104 100 103 113 107 101 101 101 101 111 100 103 200 113 113 401 113 113 401 113 113 200 104 100 103 200 300 113 200
200 104 100 103 113 113 113 200 104 100 109 101 101 101 101 101 101 101 101 105 200 104 100 103 113 104 100 100 100 100 100 100 103 200 113 113 400 300 300 400 113 113 200 104 100 103 200 113 113 200
200 104 100 103 113 113 113 200 104 100 100 100 100 100 100 100 100 100 100 103 200 104 100 103 113 106 102 102 102 102 102 102 108 200 113 113 113 113 113 113 113 113 200 104 100 103 200 113 113 200
200 104 100 103 200 200 200 200 106 102 102 102 102 102 102 102 102 110 100 103 200 104 100 103 200 200 200 200 200 200 200 200 200 200 200 200 200 200 200 200 200 200 200 104 100 103 200 113 302 200
200 104 100 103 200 300 300 200 200 200 200 200 200 200 200 200 200 104 100 103 200 104 100 103 200 113 113 113 113 113 113 113 113 113 113 113 113 113 113 113 113 113 200 104 100 103 200 113 113 200
200 104 100 103 200 300 300 200 113 113 113 113 113 113 113 113 200 104 100 103 200 104 100 103 200 113 113 113 113 113 113 113 113 113 113 113 113 113 113 113 113 113 200 104 100 103 200 113 113 200
200 104 100 103 200 300 300 200 113 113 113 113 113 113 113 113 200 106 102 108 200 106 102 108 200 113 113 113 113 113 113 113 200 200 200 200 200 200 200 200 200 200 200 106 102 108 200 200 200 200
200 104 100 103 200 200 200 200 200 200 200 200 200 200 200 200 200 113 113 113 200 200 200 200 200 200 200 200 200 200 200 200 200 107 101 101 101 101 101 101 101 101 101 101 101 101 101 101 105 200
200 104 100 103 113 113 113 200 107 101 105 113 107 101 101 101 101 101 101 101 101 101 101 101 101 101 101 101 101 105 113 113 200 104 100 100 100 100 100 100 100 100 100 100 100 100 100 100 103 200
200 104 100 103 113 113 113 200 104 100 103 113 104 100 100 100 100 100 100 100 100 100 100 100 100 100 100 100 100 103 113 113 200 106 102 102 102 102 102 102 102 102 102 102 102 102 102 102 108 200
200 104 100 103 200 200 200 200 104 100 103 113 106 102 102 102 102 102 102 102 102 102 102 102 102 102 102 102 102 108 113 113 200 107 101 105 200 200 200 200 200 200 200 107 101 105 200 200 200 200
200 106 102 108 200 300 300 200 104 100 103 200 200 200 200 200 200 200 200 200 200 200 200 200 200 200 200 200 200 200 200 200 200 104 100 103 200 113 113 113 113 113 200 104 100 103 200 113 113 200
200 113 113 113 200 300 300 200 104 100 103 200 113 113 113 113 113 113 113 113 113 113 113 113 113 113 113 113 113 113 113 113 200 104 100 103 200 113 402 113 113 113 200 104 100 103 200 113 302 200
200 113 113 113 200 300 300 200 104 100 103 200 113 113 402 113 301 113 113 113 113 302 113 113 113 113 113 113 113 402 113 113 200 104 100 103 200 113 401 113 113 113 200 104 100 103 200 113 113 200
200 113 113 113 200 200 200 200 104 100 103 200 113 113 401 113 113 113 113 113 113 113 113 402 113 300 113 113 113 401 113 113 200 104 100 103 200 113 400 113 113 113 200 104 100 103 200 113 113 200
200 107 101 101 101 101 101 101 111 100 103 200 113 113 400 113 113 300 113 113 113 113 113 401 113 113 113 113 113 400 113 113 200 104 100 103 200 113 113 113 113 113 200 104 100 103 200 113 113 200
200 104 100 100 100 100 100 100 100 100 103 200 113 113 113 113 113 113 113 113 300 113 113 400 113 113 113 300 113 113 113 113 200 104 100 103 200 113 113 113 403 113 200 104 100 103 200 113 302 200
200 106 102 102 102 102 102 102 110 100 103 200 113 113 113 113 113 113 402 113 113 113 113 113 113 301 113 113 113 113 402 113 200 104 100 103 200 113 113 113 113 113 200 104 100 103 200 113 113 200
200 200 200 200 200 200 200 200 104 100 103 200 113 113 300 113 113 113 401 113 113 302 113 113 113 113 113 113 113 113 401 113 200 104 100 103 200 113 113 113 113 113 200 104 100 103 200 113 113 200
200 113 300 113 300 113 113 200 104 100 103 200 113 113 113 113 301 113 400 113 113 113 113 113 302 113 113 113 301 113 400 113 200 104 100 103 200 113 113 200 200 200 200 104 100 103 200 200 200 200
200 113 113 113 113 113 113 200 104 100 103 200 113 113 113 113 113 113 113 113 113 113 113 113 113 113 113 113 113 113 113 113 200 104 100 103 200 113 113 200 107 101 101 111 100 109 101 101 105 200
200 200 200 200 200 200 200 200 106 102 108 200 200 200 200 200 200 200 200 200 200 200 200 200 200 200 200 200 200 200 200 200 200 106 102 108 200 200 200 200 104 100 100 100 100 100 100 100 103 200
200 107 101 101 101 101 101 101 101 101 101 101 101 101 101 101 101 101 101 101 101 101 101 101 101 101 101 101 101 101 101 101 101 101 101 101 101 101 105 200 104 100 100 100 100 100 100 100 103 200
200 104 100 100 100 100 100 100 100 100 100 100 100 100 100 100 100 100 100 100 100 100 100 100 100 100 100 100 100 100 100 100 100 100 100 100 100 100 103 200 104 100 100 100 100 100 100 100 103 200
200 106 102 102 102 102 102 102 102 102 102 102 102 102 102 102 102 102 102 102 102 102 102 102 102 102 102 102 102 102 102 102 102 102 102 102 102 102 108 200 104 100 100 100 500 100 100 100 103 200
200 113 113 113 200 200 200 200 200 200 200 200 200 200 200 200 200 200 200 200 200 200 200 200 200 200 200 200 200 200 200 200 200 200 200 200 200 200 200 200 104 100 100 100 100 100 100 100 103 200
200 113 113 113 200 113 113 113 302 113 113 113 113 113 113 113 301 113 113 113 113 113 113 113 300 113 113 300 300 113 113 113 113 113 113 300 113 113 113 200 104 100 100 100 100 100 100 100 103 200
200 113 113 113 200 113 113 113 113 113 113 113 300 300 113 113 113 113 301 113 300 300 113 113 113 113 113 113 113 113 113 302 113 113 113 113 113 301 113 200 106 102 102 102 102 102 102 102 108 200
200 200 200 200 200 200 200 200 200 200 200 200 200 200 200 200 200 200 200 200 200 200 200 200 200 200 200 200 200 200 200 200 200 200 200 200 200 200 200 200 200 200 200 200 200 200 200 200 200 200
